11111111111111111111111111111111
12222222211111111111111111111111
12222222221111111111111111111111
12222222222111111111111111111111
12222222222111111111111111111111
12222222222111111111111111111111
12222222221111111111111111113311
12222222211111111111111111111111
11111111111111111111111111111111
11111111111111111111111111113331
11111111111111111111111111111111
11111111111111111111111111111111
11111111111111111111111111111111
11111111111111111111111111111111

